1111111111
10C1000001
10P01010B1
10E100BBB1
1BBB100001
100B100001
1BBB100001
1000111001
1000001C01
1111111111