NO 220,100,0
SO 220,100,0
WE 220,100,0
EA 220,100,0
F ./path_to_the_floor_texture
C ./path_to_the_ceiling_texture
D ./path_to_the_door_texture

1111
1001
10E1
1111
