NO ./path_to_the_north_texture
SO ./path_to_the_south_texture
WE ./path_to_the_west_texture
EA ./path_to_the_east_texture
F ./path_to_the_floor_texture
C ./path_to_the_ceiling_texture
D ./path_to_the_door_texture

11111111
10010001
100100011
1000000001
110000111
10000001
1001N001
11111111
