NO ./xpms/e100.xpm
SO ./xpms/e075.xpm
WE ./xpms/vigo.xpm
EA ./xpms/e025.xpm
F 150,200,200
C  250,200,200
D ./xpms/bou1.xpm

11111111
10010001
100D00011
1000000001
110000111
10000001
1001N001
11111111
