NO ./xpms/e100.xpm
SO ./xpms/e075.xpm
WE ./xpms/e125.xpm
EA ./xpms/e025.xpm
F 150,200,200
C  250,200,200
D ./xpms/vigo.xpm

11111111
1001000D1
100D10011
1000000001
110000111
1000N001
10010001
11111111
