NO ./path_to_the_north_texture
SO ./path_to_the_south_texture
WE ./path_to_the_west_texture
EA ./path_to_the_east_texture
F ./path_to_the_floor_texture
C ./path_to_the_ceiling_texture
D ./path_to_the_door_texture

11111111
10010001111111111111111
1001000000000000D000001
10010001111111111111111
10000001
10000001
1000N001
11111111
