NO ./10,20,30
SO 20,40,60
WE     40,80,160
EA    100,100,50
F            12,23,dtgj
C      0,1234,100
D      256,2,32

11111   1111111111111111111111111111
  101      1000000000110000000000001
  111    111010000001110000000000001
        1001001000D0000000000000011
111111111011000001110000000000001
100000000011000001110111111111111
11110111111111011100000010001
11110111111111011101010000001
11000000110101011100000000001
100010000000000000000000W0001
1001 100000000001101010010001
110010011101010111110111101011111111111111111111111111
10000001 1110101 1011110100000000000000000000000001
11111111 1111111 111111111111111111111111111111111
