NO  ./xpms/bigstones.xpm
SO ./xpms/holebrick.xpm
WE ./xpms/vinebrick.xpm
EA ./xpms/whitebrick.xpm
F 220,100,0
D ./xpms/title.xpm
C  012,123,234

        1111111111111111111111111111
   11      1000000000110000000000001
   11    111011000001110000000000001
        1001000000D0000000000000111
111111111011000001110000000000001
100000000011000001110111111111111
11110111111111011100000010001
11110111111111011101010000001
11000000110101011100000000001
1000100000000S000000000000001
1001 100000000001101010010001
110010011101010111110111101011111111111111111111111111
10000001 1110101 1011110100000000000000000000000001
11111111 1111111 111111111111111111111111111111111
