NO ./xpms/bigstones.xpm
SO ./xpms/holebrick.xpm
WE ./xpms/vinebrick.xpm
EA ./xpms/whitebrick.xpm
F ./path_to_the_floor_texture
C ./path_to_the_ceiling_texture
D ./xpms/metaldoor.xpm

1111111111111111111111111
1000000000110000000000001
1011000001110000000000001
100100000000000000000000111111111
11111111101100000111000000D000001
10000000001100000111D111111111111
111101111111110111000000D0001
11110111111111011101010010001
11000000110101011100000010001
10000000000000001100000010001
10000000000000001101010010001
11000001110101011111011110W0111
11110111 1110101 101111010001
11111111 1111111 111111111111
