11111111111111111111111111111111111111
1P000000000000000000000000000000000001
1000111111111000B000001111111111000001
10001000000010000000001000000001000001
10001000000011111111111000000001000001
10001000000000000000000000000001000001
10001000000000000000000000000001000001
10001111111111000000001111111111000001
100000000000010000000010000000C0000001
10000000000001000000001000000000000001
11111111111101111111111011111111111111
10000000000000000000000000000000000001
10000000000000000000000000000000000001
10000011111111111111111111000000000001
10000000000000000000000001000000000001
10000000000000000000000001000000000001
10000000001111111111111001000000000001
10000000001000000000000001000000000001
100000000010000000000000000000000000E1
11111111111111111111111111111111111111
