11111111111111111111111111111111111111
11000000000000000000000010000000000001
1100B000000000000000000010000000000001
11000000000000000000000010000000000001
11000000000000000000000010000000000001
11000000000000000000000010000000000001
11000000001111110000001000000000000001
110000000011111100000010E0000000000001
11000000001111110000100000000000C00001
11000000001111110000100000000000000001
10000000001111110000000100000000000001
11000000001111110000000110000000111001
11000000000000000000000P10000000100001
11000000B0B000000000000110000000100001
110000000000000CB00000000B000000100001
110000000000000000000C0000000000100001
1100B00000C000000000000000000011100001
1100000000000000000000C000000010000001
11000000000000000000000000000010000001
11111111111111111111111111111111111111