11111111111111111111111111111111111111
1P010000000000000000000000000000000001
1001BB00000000000000000000000000000001
101BCB00000000000000000000000000000001
101BBB00000000000000000000000000000001
10100000000000000000000000000000000001
1B100000000000000000000000000000000001
1BBC0000000000000000000000000000000001
1010001000000B000000000000000000000001
1C1000100000000000000C0000000000000001
10100010000000000000000000000000000001
10100010000000000000000000000000000001
10111110000000000000000000000000000001
10000000000000000000000000000000000001
10000000111111000000000000000000000001
10111110100000000000000000000000000001
10100010100000000000000000000000000001
10101010100000000000000000000000000001
100000001000000000000000000000000000E1
11111111111111111111111111111111111111