11111111111111111111111111111111111111
1P000000B000000000C0000BBB000000000001
10001111101111111111111110111111111001
10001000001000000000000000000000001001
10001000001B11111111111111111110001001
10001000001000000000000000000010001001
10001000001111111111111B00000010001001
100010B0000000000000001001111110001001
100010B11111111111111010B1000000001001
100010000000000000000010010000C0001001
11001111111111111111111B01111111111001
1C1000000000000000000000000000000B1001
100111111011111111111111111110000B1001
100000B001000000000000000001000001B001
11111110001111111111111000001001111001
1B000000000000000000010000010000100001
11111111000001111111001111101000100001
1C00000000011E100000000000010000CB00B1
100000000B0010000000000000000000000B01
11111111111111111111111111111111111111
