11111111111111111111111111111111111111
1P0000000B00000000C00000BB000000000001
10001111101111111111111110111111111001
10001000001B00000000000000000000001011
10001000001B1111111111111111111BB01001
10001000001000000000000000000010001101
10001000001111111111111B00000010011001
100010B0000000000000001001111110001101
10001BB11111111111111010B1000000011001
100010000000000000000010010000C0001001
11001111111111111111111B01111111111001
1C1000000000000000000000000000000B1001
10011111101111111111111111111BBB0B1001
100000B001000000000000000001000001B001
111111100011111111111110000B10B1111001
1B00000010000000000001000001B000100001
11111111B00001111111B0100B1B1000100001
1C000B1000011E1000B000B11B010000CB00B1
100B00000B0010001000B00000000000000B01
11111111111111111111111111111111111111
