11111
1PE01
1C111
11CC1
11111
